exc|exc|snippets
isomo|isomorphic|dictionary
resolu|resolution|dictionary
rmk|rmk|snippets
Classifyig|Classifying|dictionary
cor|cor|snippets
existen|existence|dictionary
uniqu|uniqueness|dictionary
ZZpad|ZZpadic|dictionary
ex|ex|snippets
princi|principal|dictionary
surjec|surjection|around
neces|necessary|dictionary
Nullstel|Nullstellensatz|dictionary
corol|corollary|dictionary
gener|generated|around
finite|finitely|around
soln|soln|snippets
algebraical|algebraically|dictionary
Artn|Artin|around
lem|lem|snippets
Lefsch|Lefschetz|dictionary
nonvan|nonvanishing|dictionary
def|def|snippets
proof|proof|snippets
prop|prop|snippets
struc|structur|dictionary
resolut|resolutions|around
minimal|minimal|dictionary
Cohomol|Cohomology|dictionary
structu|structur|dictionary
algeb|algebra|dictionary
uniqu|unique|around
irredu|irreducible|around
nonemp|nonempty|around
componen|components|around
irredu|irreducibles|around
Nother|Noetherian|around
Notherian|Noetherian|around
irred|irreducible|around
irreduc|irreducible|around
thm|theorem|snippets
similarl|similarly|dictionary
irredu|irreducible|dictionary
reducib|reducible|dictionary
Zarisk|Zariski|dictionary
identiied|identified|dictionary
dashrigh|dashrightarrow|vimtex
Toho|Tohoku|dictionary
Groth|Grothendieck|around
corol|corollary|around
ef|effaceable|around
Univera|Universal|dictionary
monomo|monomorphism|around
Efface|Effaceable|around
slogan|slogan|snippets
monomo|monomorphism|dictionary
effa|effaceable|around
necess|necessarily|dictionary
hands|handshake|emoji
Grothen|Grothendieck|dictionary
rmk|remark|word